6
4 5
1 1 1 0 0 2
0 0 3 0 0 2
4 4 3 0 0 2
5 0 3 0 6 6
5 0 0 0 7 0
8 8 8 0 7 0