7
6 6
1 2 0 0 0 0 3
1 2 0 4 4 4 3
1 5 5 6 6 7 7
0 0 0 0 0 7 7
0 0 0 0 0 8 0
9 9 0 0 0 8 0
10 10 10 11 11 8 0